********************************************************
*        *         *            *   **  ***       *    *
*    *   **  ***       *        *   **  ***       *    *
*    *    *    *   *   *        *   **  ***       * E  *
*    *    *       *    *        *   **  ***       *    *
*    *    *    *         *      *   **  ***            *
*    *    *    *****  *  *      *   **  ***       *    *
*         *    *   *            *   **            *    *
*    *    ******       *        *   **  ***       *    *
*    *    *    *   *   *        *   **  ***       *    *
*         *       **   *        *   **  ***       *    *
*    *    ** ***         *      *   **  ***       *    *
*    *         *****  *  *      *       ***       *    *
*         *        *            *   **  ***       *    *
** ***    *  ***       *        *   **  ***       *    *
*    *    *    *   *   *        *   **  ***       *    *
*    ******    *  *    *        *   **  ***       *    *
*    *    *    *         *      *   **  ***       *    *
*    *         *****  *  *      *   **  ***       *    *
*    *    *        *            *   **  ***       *    *
*         ******       *        *   **  ***       *    *
*    *    *    *   *   *            **  ***       *    *
*    *    *       *    *        *   **  ***       *    *
*    *    *    *         *      *   **  ***       *    *
*S   *         ***    *  *      *   **  ***       *    *
********************************************************
