+-+-+-+-+-+-+-+-+-+-+-+-+-+-+-+-+-+-+-+-+
S |   |   |       |           |         |
+ + + + + +-+-+-+ + +-+-+ +-+ + +-+-+-+ +
| | |   | |       |   | | |   |     | | |
+ + + +-+-+ +-+ +-+-+ + + + + +-+-+ + + +
|   |       | | |   | |   | | |   | | | |
+-+-+-+-+-+ + + + + + +-+-+-+ + + + + + +
|           |   | |     |     | |   |   |
+ +-+-+-+-+-+-+-+ +-+ + + +-+-+-+-+ +-+-+
| |     |         |   | |       |   |   |
+ + +-+ +-+-+-+-+-+-+-+ + +-+-+ + +-+ + +
|   |   |     |   |     |     |   |   | |
+-+-+ +-+ +-+ + + + +-+-+-+-+-+ +-+ +-+ +
|   | | | |   | | | |   |     |     | | |
+ + + + + + +-+-+ + + +-+ +-+ +-+-+-+ + +
| | |   | |     |   |     |   |     |   |
+ +-+ +-+ +-+-+ +-+ +-+-+-+ +-+ +-+-+-+ +
|   |   | |   |     |     |       |     |
+ + +-+ + + +-+-+-+-+ +-+-+-+-+ + + + +-+
| |       |                     |   |   E
+-+-+-+-+-+-+-+-+-+-+-+-+-+-+-+-+-+-+-+-+
