***************************************************E*************************************************
*   *       *     *                 *           *             *                 *         *     *   *
* *** * *** * * *** * * ***** ***** * *** ***** * * ********* *** ************* ******* *** * * *** *
*     * * * * * *   * * *   * *   * *   * *   * * * *     * *   * *       *     *       *   * * *   *
* ***** * * * * * *** *** * *** * * ***** * * * * * * *** * *** * * ***** * ***** *** *** *** * * * *
* *     *   * * *   *     *   * * *       * * * * *     * *   * *   *     *       *   *   *   *   * *
*** ***** *** * *** ********* * * ********* * * * ******* *** * ***** ************* *** *** ******* *
*   *   * * * *   *   *     *   *   * *   * * * * *   *   *   *     *   *         *   * *   *       *
* ***** * * * *** *** * * ********* * * * * * * * * * * *** ******* * * * *********** * * ***** *****
* *     * * * *     * * *         * *   *   * * *   * *   *     *   * * * *           * *     * *   *
* * * * * * * * ***** *** * ***** * ***** *** * ********* * * * * *** * * * *********** ***** * *** *
* * * * * * * * *   *   * * *   * * *   * *   * *     *   * * * *   * * * * *     *     *   * *     *
* *** * * * * * * * *** *** * *** * * * * * * * * *** * *** * * *** * * * * * ***** ******* * ***** *
*   * * * *   *   *   *     *     *   * * * * *   *   *   * * * *   * * *     *     *     * *   *   *
*** * *** ***** ***** ******* ********* *** * ***** ***** *** *** ***** * ***** ***** *** * *** * ***
*   *   *     * *         *       *   * *   * * *   *     *   *         * *   *       * * *   * *   *
* *** * ***** *** *** ***** ******* * * * *** * * ***** *** * * *********** * ********* * *** * *****
* *   * *     *   * * *     * *     * * * *     * *     *   * * *           *     *       *   *     *
* * *** * ***** *** * * ***** * ***** * * * ***** * ***** * *** * ************* *** ******* ******* *
* *   *     *   * *   *   *   *   *     * *   *   * *     * *   *   * *       *   *   *     *     * *
* ********* * *** * ***** * ***** ******* *** * *** ***** * * ***** * * ***** *** *** *** * * *** * *
* *     * *   * *     *   *     *     *     * * *       * *       *   * *         *   *   * * *   * *
* * *** * ***** * ***** *** * ******* ***** *** ******* ********* *** * * ******* * *** * *** * *** *
*     * *       *   *   *   *       *     * *   *       *   *   * *   * * *   *   * *   * *   *     *
* ***** * *** *** *** ******* *** * ***** * * *** *** *** * *** * * *** * * * *** * *** * * ******* *
*   *   * * *     *   *     *   * * * *   *   *     * *   *   *   *   * * * *   * * *   * * *   *   *
* *** *** * ******* *** * * *** * * * * *** ******* *** ***** *** *** * *** *** *** * *** * * * *** *
* *   * * *   *   *   * * * *   * *   * *       *   *   *   *   * *   * *   * *   *   *   *   *   * *
*** *** * * * * ***** * * * ***** *** * ******* * * * *** ***** *** *** * *** *** *** *********** ***
*   * *   * *   *     * * *     * *   * *   *     * * *       * *   *   *       *     *         *   *
* *** * *** *** * ******* ***** * * *** * * ********* ******* * * *** *** ***** ***** * * ***** *** *
* * *   *   *   * *       *   * * *   *   *         * *       * *   *     *   * *   * * * *   *     *
* * * ***** * *** * ********* * * *** ************* * * ***** * *** ******* * *** * * * *** * ***** *
* * * *     *   * * *         *   * * *   *       *   *   *   *   *   *     * *   * * * *   * *   * *
* * * *** ***** * * * *** * ******* * * * * * *********** * *** ***** * ***** * *** *** * *** * * * *
* *       * *   *   * *   * *       * * * * *       *     *   *       * *   *   * *   *   * * * * * *
* ********* * ********* * *** ***** * * *** ***** * *** *************** * ******* *** * *** * * * ***
* *   *   *   *         * *   *   * * * *   *   * *   * *           *   * *     *   * *     * * *   *
* * * * * * *** ***** *** * *** * * * * * *** * * *** * * ***** ***** *** * *** * * * ***** * * *** *
*   * * *   *   *     *   * *   * *   *   *   *   *   *   *   * *     *     *   * * * * *   *     * *
* *** * ******* * ***** *** *** * ***** *** ******* *** *** *** * *********** * * * * * * ********* *
*   * * *     * * *   * * *     * *   * * * * *   * *       *   *   *       * * * * * *   *     *   *
***** * *** * *** * * * * ******* * *** * * * * * * ******* * ***** * ***** * *** * * * *** *** * ***
*     *   * *     * * * *   *     * *     * * * *   *   *   *     *   * *   *     * * *     *   *   *
* ******* * ******* * * * * * ***** * ***** * * ***** * *** *** ******* * ******* * * ***** ******* *
* *       * *       *     * * *       *     * * *     *   *   *       * * *     * *     *   *       *
* *** ***** *********** ***** * ******* ***** * * * ***** * ******* * * * * *** ******* * *** ***** *
*   *     * *   *     * *   * * * *   * *     * * *   *   * *     * *   *   * *     *   * * *     * *
* * ***** * * * * *** *** * * * * * * * ***** * *** * * ***** *** * *** ***** ***** * *** * ***** ***
* *   *     * *     *   * *   *   * *   *   * *   * * * *     * * *   *     *     * * *   *     *   *
***** ******* ********* * ******* * ***** * * *** *** * * ***** * * * ***** *** * * * * *** ******* *
*   *       * *         *     *   *       * *   *     * * *       * *     *     * * * *   * *     * *
*** *** *** * * ************* * ********* * * * ******* * * ******* ***** ***** *** * *** * * * *** *
* *   * * * * *     *       * * *       * * * *     *   * *   *   *     * *     *   *   * *   * *   *
* *** * * * * ***** * ***** * *** ***** *** * ***** * *** *** * *** ***** ******* ***** * ***** * * *
*     *   * * *   *   *   *   *   *   *   * *     *   *   * * *     *   * *       *     *     * * * *
* ***** *** * * * ***** * ***** *** * *** * ***** ***** *** * *** *** * * * ******* ********* * * * *
*     * *   *   *       *       *   * *   * *   *       *   *   * *   * * * *       *           * * *
***** *** ************* ********* ***** *** * * ********* * *** *** *** * * *** ***** *********** ***
*   *   *           *   *     *           * * *       *   *   * *   * * * *   *   *     *   *   *   *
* * *** ********* * * *** *** * ********* * * ******* ***** *** * *** * * *** *** ***** * * * * *** *
* * *   *   *   * *   *   *   *   *     *   * *     * *   *       * *   * *   * *   *     * * *     *
* * * *** * * * * ***** *** ******* *** ***** ***** * * * ********* * *** * *** *** ******* * ***** *
* * * *   *   * *     *   *         * *       *     * * *     *           *   *       *   * *   *   *
* * * * ******* ********* *********** ********* ***** * ***** * ********* *** * ***** * * ***** * ***
* * * *     * *         *   *           *   *       * * * *   *   *     * * * * *   *   *       *   *
*** * ***** * ********* * * * *********** * * ***** * * * * ***** * *** * * * *** * ***** ********* *
*   * *     *   *     * * * * *     *     *   *   * *   * *   *   * *   *   * *   *   *   *   *   * *
* * * * ***** * * * * * *** * * *** * *********** * ***** *** * *** * ***** * * ***** * *** * *** * *
* * *   * *   *   * * *   * *   *   * * *     *   *   *   *   *   * *   * * * * *   * *   * *   *   *
* ******* * ***** * ***** * * *** * * * * * * * *** * * *** ******* *** * * * * *** * *** * *** * ***
*   *       *   * *     *   * *   * * *   * * * *   * *   *         *   * * * *   * *   * * * * *   *
* * * ******* * * *** ********* *** * * *** * * * *** *** *********** *** * * *** * *** *** * * *** *
* *   * *     * *   *         * * * * *   * *   * * *     *   *   *   *     *   *   *   *   * *   * *
* ***** * ***** ********* *** * * * * ***** * *** * ***** * * * * * ********* *** *** * * *** *** ***
* *     * *   *         * *   * *   *       * *   *     *   *   * *         * *   *   * * *     *   *
* *** * * *** ********* * * *** * *********** * ******* ********* ********* * * *** *** * * *** *** *
* *   * * *       *   *   *     *     *     * *       *         * *       * * *   * *   *   *   *   *
* * *** * * ***** *** *************** ***** * ******* * * *** *** * * *** * * *** * * ******* *** * *
* * *   * *   *       *     *   *   *   *   *       * * *   * *   * *   * * *     * *     *   * * * *
* * ***** * * ******* * *** * * * ***** * * ******* * *** * *** *** *** * * *** *** ***** * *** * ***
*   *     * *   *       *   * * *     *   *       * *   * *       *   * * *   * *   *     *     *   *
*** * ***** *** ********* *** * ***** ***** ******* *** *********** *** * *** *** *** ***** ******* *
*   * *   * *   *       *     *       *     *     * *   *           *   * * *   * *   *     *       *
***** *** * * *** ***** *************** ***** *** * * *** *********** *** * *** * ***** ***** ***** *
*   *   *   *   * *   *                   *   * *   * *   *   *   *   * *   *   *           * *   * *
* * *** ******* * * ********* ************* *** ***** * *** *** * * *** *** * *** *********** * *** *
* *     *   *   * *     *   *       *       *       * *     *   *   *       *   * * *   *     *     *
* ******* * * * * ***** * * ********* ******* *** * * ***** * * *************** * * * * * ***** *****
* *     * * * * *     * * * *       * *   *     * * *   *   * * *             * *   * * *   * * *   *
* * *** * * * * ***** * * * * ***** * * * * ***** ***** * *** * * *********** * *** * * *** * * * * *
* *   *   * * * *       * *   *   *   * * * *     *   *     * * *           * *   * * *     * * * * *
* *** ***** * *** ******* ******* ***** * * * ***** * * ***** * *********** * *** *** ******* * * * *
*   * *     * *       *   *         *   * * *   *   * * *   * *         * * *   * *   *   *     * * *
* * * * ***** * ******* ******* *** *** *** *** * *** *** * * ********* * * *** * * *** * * ***** ***
* *   * *       *       *       * *   *     *   * *       *   *     *     *   *   *     * *   *     *
* ***** ********* ******* ******* *** * ***** * * ************* *** *** ***** ******* *** *** *** * *
*     * *     *   *     *   *       * * *     * *     *   *   *   *   * *   * *     *   * * *   * * *
***** * * *** * ***** * *** * * ***** *** ***** ***** * * * * *** *** *** * * *** * ***** * *** *** *
*     *     *         *     * *           *         *   *   *       *     *       *       *         *
***************************************************S*************************************************
