+-+-+-+-+-+-+-+-+-+-+-+-+-+-+-+-+-+-+-+-+-+-+-+-+-+-+-+-+-+-+-+-+-+-+-+-+-+-+-+-+-+-+-+-+-+-+-+-+-+-+
S       |   | |   |               |           |         |   |   |   |         |   |   |         |   |
+ +-+-+ + + + + + + +-+-+-+-+-+-+ +-+-+ + +-+ + +-+-+-+ + + + + + + + +-+-+-+ + + + + + +-+-+-+ + + +
|   | | | |   | | |     |       |       | |   |   | |   | |   | | |   |     | | |   | |   |     | | |
+-+ + + + + +-+ + +-+-+ + +-+-+ +-+-+-+-+ +-+ +-+ + + +-+ +-+-+ + +-+-+ +-+ + + +-+-+ +-+ + +-+-+ + +
|   |     |   | | |     | |   |   |   | |   |     |   |   |   | | |   | |   | |   |     | |       | |
+ +-+-+-+-+-+ + + +-+-+-+ + + +-+ + + + +-+ +-+-+-+-+-+ +-+ + + + +-+ + + +-+ +-+ +-+-+-+ + +-+-+ + +
| |     |   |   |   |   |   |   | | |   | | |           |   | | | |   | | | | | |       | | |     | |
+ + +-+ + + +-+-+-+ + + + + +-+ +-+ +-+ + + +-+ +-+-+-+-+ +-+ + + + +-+ + + + + +-+-+ + + +-+ +-+-+ +
| | |   | |     | | | | | |   |   | |   | | |   |     |   | |   | | |   |   |       | | |   |     | |
+ + +-+-+-+-+-+ + + +-+ +-+-+ +-+ + +-+-+ + + +-+ + +-+ +-+ +-+-+ + + +-+-+-+-+-+-+ +-+ +-+ +-+ + + +
| |             | |   |     |   | | |   |   | |   |     | |     | | | | |               | |   | | | |
+ +-+ +-+-+-+-+ + +-+ +-+-+ +-+-+ + + + + +-+ + +-+ +-+-+ + +-+-+ + + + + + +-+-+-+ +-+-+ +-+ + + + +
|   |   |     | |     |   |     | |   | | |   | | |       | |   |   |     |   |   |       |   | | | |
+-+ +-+ +-+-+ + +-+-+-+ + +-+-+ + +-+-+ + + +-+ + + +-+-+ + + + +-+-+-+ +-+-+ + +-+-+-+-+ + +-+ + +-+
|       |   | |   |     |     | |       |   |   | |     | |   |   |   | |     |   | |   | | |   |   |
+ +-+-+-+ + + +-+ + +-+-+-+-+-+ +-+ +-+ + +-+ +-+ +-+-+ +-+-+ +-+ + + + +-+-+ +-+ + + + + + +-+-+-+ +
| |   |   |   | |     |   |     |   | |   | |   |   | |       |   | | |   |   |   |   |     |       |
+ + + + + +-+-+ +-+ +-+ + + +-+ + +-+ +-+ + +-+ +-+ + +-+-+-+ + +-+-+ +-+ + +-+ +-+-+-+-+-+-+ +-+-+ +
|   |   |         |     |   |         |   |         |         |           |   |               |     E 
+-+-+-+-+-+-+-+-+-+-+-+-+-+-+-+-+-+-+-+-+-+-+-+-+-+-+-+-+-+-+-+-+-+-+-+-+-+-+-+-+-+-+-+-+-+-+-+-+-+-+
