************
*     *   E*
*  *  *  * *
*     *    *
* *        *
* *   *    *
*S*   *    *
************
