*****************************************************************************************************
*   *       *     *                 *           *E            *                 *         *     *   *
* *** * *** * * *** * * ***** ***** * *** ***** * * ********* *** ************* ******* *** * * *** *
*     * * * * * *   * * *   * *   * *   * *   * * * *     * *   * *       *     *       *   * * *   *
* ***** * * * * * *** *** * *** * * ***** * * * * * * *** * *** * * ***** * ***** *** *** *** * * * *
* *     *   * * *   *     *   * * *       * * * * *     * *   * *   *     *       *   *   *   *   * *
*** ***** *** * *** ********* * * ********* * * * ******* *** * ***** ************* *** *** ******* *
*   *   * * * *   *   *     *   *   * *   * * * * *   *   *   *     *   *         *   * *   *       *
* ***** * * * *** *** * * ********* * * * * * * * * * * *** ******* * * * *********** * * ***** *****
* *     * * * *     * * *         * *   *   * * *   * *   *     *   * * * *           * *     * *   *
* * * * * * * * ***** *** * ***** * ***** *** * ********* * * * * *** * * * *********** ***** * *** *
* * * * * * * * *   *   * * *   * * *   * *   * *     *   * * * *   * * * * *     *     *   * *     *
* *** * * * * * * * *** *** * *** * * * * * * * * *** * *** * * *** * * * * * ***** ******* * ***** *
*   * * * *   *   *   *     *     *   * * * * *   *   *   * * * *   * * *     *     *     * *   *   *
*** * *** ***** ***** ******* ********* *** * ***** ***** *** *** ***** * ***** ***** *** * *** * ***
*   *   *     * *         *       *   * *   * * *   *     *   *         * *   *       * * *   * *   *
* *** * ***** *** *** ***** ******* * * * *** * * ***** *** * * *********** * ********* * *** * *****
* *   * *     *   * * *     * *     * * * *     * *     *   * * *           *     *       *   *     *
* * *** * ***** *** * * ***** * ***** * * * ***** * ***** * *** * ************* *** ******* ******* *
* *   *     *   * *   *   *   *   *     * *   *   * *     * *   *   * *       *   *   *     *     * *
* ********* * *** * ***** * ***** ******* *** * *** ***** * * ***** * * ***** *** *** *** * * *** * *
* *     * *   * *     *   *     *     *     * * *       * *       *   * *         *   *   * * *   * *
* * *** * ***** * ***** *** * ******* ***** *** ******* ********* *** * * ******* * *** * *** * *** *
*     * *       *   *   *   *       *     * *   *       *   *   * *   * * *   *   * *   * *   *     *
* ***** * *** *** *** ******* *** * ***** * * *** *** *** * *** * * *** * * * *** * *** * * ******* *
*   *   * * *     *   *     *   * * * *   *   *     * *   *   *   *   * * * *   * * *   * * *   *   *
* *** *** * ******* *** * * *** * * * * *** ******* *** ***** *** *** * *** *** *** * *** * * * *** *
* *   * * *   *   *   * * * *   * *   * *           *   *   *   * *   * *   * *   *   *   *   *   * *
*** *** * * * * ***** * * * ***** *** * ******* * * * *** ***** *** *** * *** *** *** *********** ***
*   * *   * *   *     * * *     * *   * *   *     * * *       * *   *   *       *     *         *   *
* *** * *** *** * ******* ***** * * *** * * *** ***** ******* * * *** *** ***** ***** * * ***** *** *
* * *   *   *   * *       *   * * *   *   *         * *       * *   *     *   * *   * * * *   *     *
* * * ***** * *** * ********* * * *** ************* * * ***** * *** ******* * *** * * * *** * ***** *
* * * *     *   * * *         *   * * *   *           *   *   *   *   *     * *   * * * *   * *   * *
* * * *** ***** * * * *** * ******* * * * * * *********** * *** ***** * ***** * *** *** * *** * * * *
* *       * *   *   * *   * *       * * * * *       *     *   *       * *   *   * *   *   * * * * * *
*                                                                                             S     *
*****************************************************************************************************
